#############################
#   #   #   #   #   #     # #
# # ### ### ### ### ### # # #
# #       # # # # #     # # #
######### # # # # ### ##### #
# # # #   # #             # #
# # # ### # ### ########### #
#   #           #     #   # #
### ######### # # ### ### # #
#   # # #   # # #   #   # # #
### # # #          ###### # #
#                     # #   #
### #####           ### # ###
#     #                     #
### ######         #### #####
#   #   #             #     #
# ##### ##         #### # ###
#     # #             # # # #
####### ##         ## # ### #
#     #     # #       #     #
### # # # # # ### ### # # # #
#   # # # # # #     # # # # #
### ####### # # # # ### #####
#           # # # #   #     #
# # # # ### # ### ##### # ###
# # # # #   #   #     # # # #
# ### ##### # # # # ##### # #
# #     #   # # # #   #     #
#############################
