#############################
# # # #     #     # # #     #
# # # ### ####### # # # #####
# #   # # #   # #           #
# ### # # ### # # ###########
# #       # #     # #     # #
# # # ### # # ##### ##### # #
#   # # # # # #             #
# ##### # # # ### ######### #
#   # #       # #         # #
# ### ### # ### # # ### # ###
# #       #   # # # # # #   #
###########       # # #######
#                 # #       #
##### ### ##     #### ##### #
# #   #   #               # #
# # # ### #      #### ### ###
#   # #   #         # # #   #
##### # # # # # ### ### #####
#     # # # # # # #     #   #
####### ### # # # ####### ###
#         # # #       # #   #
### ### ### ##### ### # # ###
# # #   #     #   #         #
# # # # ### # ### # # # #####
#   # # #   #   # # # #     #
# # ####### ######### # ### #
# # #           #     #   # #
#############################
