#####################
# # # #     #     # #
# # # ### ### ##### #
# #   # # #     # # #
# ### # # ### ### # #
#         # #   # # #
####### ### # ### # #
#   #     # #   # # #
### ###       ### # #
#             #     #
### ###      ## ### #
# # #             # #
# ######     #### ###
#               #   #
# ### # ### # ### ###
#   # # #   # # #   #
##### # ### ### #####
#     # #         # #
# # # ##### ### ### #
# # #   #   #       #
#####################
